:96::::54:3::58:::62::::54:3::58::::54::58:::::54:3::55::::54:0:::54::58:::96:::54:0::62::80::115::1
06::104::106::111::79::112::101::102:::54::58:::::54:3::55::::54:0:::54::58:::96:::54:1::62:::54:1::
57::55::57::::54:3::54::::54:0::58::56:::54:0:::54::58:::::54:3::55::::54:0:::54::58:::96:::54:2::62
:::54:1:::54::58:::::54:3::55::::54:0:::54::58:::96:::54:3::62:::54::58:::::54:3::55::::54:0:::54::5
8:::96::54::62:::54::58:::::54:3::55::::54:0:::54::58:::96::55::62::::54:3::58::::54::58:::::54:3::5
5::::54:0:::54::58:::96::56::62::::54:3::58::::54::58:::::54:3::55::::54:0:::54::58:::96::57::62:::5
4::58:::::54:3::55::::54:0:::54::58:::::54:3::55:::::54:3::55:::102::111::101::::54:3::55:::::54:3::
55::::54::58:::::54:3::55::::54:0:::54::58:::96::::54:3::58:::62:::54:0:::54::58:::::54:3::55::::54:
0:::54::58:::96:::54:0::62::69::106::98::109::112::104::118::102::79::112::101::102:::54::58:::::54:
3::55::::54:0:::54::58:::96:::54:1::62:::54:2::58::::54:3::58:::58::::54:3::54::::54:1::::54:3::58::
::54:0:::54:0:::54::58:::::54:3::55::::54:0:::54::58:::96:::54:2::62:::54:0::::54:3::58::::54::58:::
::54:3::55::::54:0:::54::58:::96:::54:3::62:::54::58:::::54:3::55::::54:0:::54::58:::96::54::62::90:
:112::118::::54:2:::54:2:::105::98::119::102::::54:2:::54:2:::117::105::102::::54:2:::54:2:::114::11
8::102::116::117:::54::58:::::54:3::55::::54:0:::54::58:::96::55::62::::54:3::58::::54::58:::::54:3:
:55::::54:0:::54::58:::96::56::62::55::::54:3::58::::54::58:::::54:3::55::::54:0:::54::58:::96::57::
62:::54::58:::::54:3::55::::54:0:::54::58:::::54:3::55:::::54:3::55:::102::111::101::::54:3::55:::::
54:3::55::::54::58:::::54:3::55::::54:0:::54::58:::96::::54:3::58:::62:::54:1:::54::58:::::54:3::55:
:::54:0:::54::58:::96:::54:0::62::68::112::111::101::106::117::106::112::111::79::112::101::102:::54
::58:::::54:3::55::::54:0:::54::58:::96:::54:1::62:::54:2:::54:1::56::58::::54:3::54::::54:0::58::58
:::54:3:::54::58:::::54:3::55::::54:0:::54::58:::96:::54:2::62::54:::54::58:::::54:3::55::::54:0:::5
4::58:::96:::54:3::62:::54:3:::54::58:::::54:3::55::::54:0:::54::58:::96::54::62::73::98::116::::54:
2:::54:2:::82::118::102::116::117:::54::58:::::54:3::55::::54:0:::54::58:::96::55::62::::54:3::58:::
:54::58:::::54:3::55::::54:0:::54::58:::96::56::62::::54:3::58::::54::58:::::54:3::55::::54:0:::54::
58:::96::57::62::85::102::116::117:::54:0:::54:0:::54::58:::::54:3::55::::54:0:::54::58:::::54:3::55
:::::54:3::55:::102::111::101::::54:3::55:::::54:3::55::::54::58:::::54:3::55::::54:0:::54::58:::96:
:::54:3::58:::62:::54:2:::54::58:::::54:3::55::::54:0:::54::58:::96:::54:0::62::69::106::98::109::11
2::104::118::102::79::112::101::102:::54::58:::::54:3::55::::54:0:::54::58:::96:::54:1::62:::54:2::5
8:::54:0:::54:0::::54:3::54::::54:0::57::55:::54:2:::54::58:::::54:3::55::::54:0:::54::58:::96:::54:
2::62::57:::54::58:::::54:3::55::::54:0:::54::58:::96:::54:3::62:::54::58:::::54:3::55::::54:0:::54:
:58:::96::54::62::90::112::118::::54:2:::54:2:::105::98::119::102::::54:2:::54:2:::100::112::110::11
3::109::102::117::102::101::::54:2:::54:2:::117::105::102::::54:2:::54:2:::114::118::102::116::117::
:54::58:::::54:3::55::::54:0:::54::58:::96::55::62::::54:3::58::::54::58:::::54:3::55::::54:0:::54::
58:::96::56::62::55::::54:3::58::::54::58:::::54:3::55::::54:0:::54::58:::96::57::62:::54::58:::::54
:3::55::::54:0:::54::58:::::54:3::55:::::54:3::55:::102::111::101::::54:3::55:::::54:3::55::::54::58
:::::54:3::55::::54:0:::54::58:::96::::54:3::58:::62:::54:3:::54::58:::::54:3::55::::54:0:::54::58::
:96:::54:0::62::69::106::98::109::112::104::118::102::79::112::101::102:::54::58:::::54:3::55::::54:
0:::54::58:::96:::54:1::62:::54:2::58::::54:3::58:::58::::54:3::54::::54:1:::54:0::55::::54:3::58:::
:54::58:::::54:3::55::::54:0:::54::58:::96:::54:2::62::55:::54::58:::::54:3::55::::54:0:::54::58:::9
6:::54:3::62:::54::58:::::54:3::55::::54:0:::54::58:::96::54::62::90::112::118::::54:2:::54:2:::69::
112::111::117::::54:2:::54:2:::105::98::119::102::::54:2:::54:2:::117::105::102::::54:2:::54:2:::114
::118::102::116::117:::54::58:::::54:3::55::::54:0:::54::58:::96::55::62::::54:3::58::::54::58:::::5
4:3::55::::54:0:::54::58:::96::56::62::55::::54:3::58::::54::58:::::54:3::55::::54:0:::54::58:::96::
57::62:::54::58:::::54:3::55::::54:0:::54::58:::::54:3::55:::::54:3::55:::102::111::101::::54:3::55:
::::54:3::55::::54::58:::::54:3::55::::54:0:::54::58:::96::::54:3::58:::62::54:::54::58:::::54:3::55
::::54:0:::54::58:::96:::54:0::62::68::112::111::101::106::117::106::112::111::79::112::101::102:::5
4::58:::::54:3::55::::54:0:::54::58:::96:::54:1::62:::54:2::54::57:::54:2::::54:3::54::::54:0::57::5
8::54:::54::58:::::54:3::55::::54:0:::54::58:::96:::54:2::62:::54:2:::54::58:::::54:3::55::::54:0:::
54::58:::96:::54:3::62:::54:0:::54::58:::::54:3::55::::54:0:::54::58:::96::54::62::73::98::116::::54
:2:::54:2:::68::112::110::113::109::102::117::102::101::::54:2:::54:2:::82::118::102::116::117:::54:
:58:::::54:3::55::::54:0:::54::58:::96::55::62::::54:3::58::::54::58:::::54:3::55::::54:0:::54::58::
:96::56::62::::54:3::58::::54::58:::::54:3::55::::54:0:::54::58:::96::57::62::85::102::116::117:::54
:0:::54:0:::54::58:::::54:3::55::::54:0:::54::58:::::54:3::55:::::54:3::55:::102::111::101::::54:3::
55:::::54:3::55::::54::58:::::54:3::55::::54:0:::54::58:::96::::54:3::58:::62::55:::54::58:::::54:3:
:55::::54:0:::54::58:::96:::54:0::62::80::113::117::106::112::111::79::112::101::102:::54::58:::::54
:3::55::::54:0:::54::58:::96:::54:1::62:::54:3:::54:1::::54:3::58::::54:0::::54:3::54::::54:1:::54:0
::55::::54:3::58::::54::58:::::54:3::55::::54:0:::54::58:::96:::54:2::62::56:::54::58:::::54:3::55::
::54:0:::54::58:::96:::54:3::62:::54::58:::::54:3::55::::54:0:::54::58:::96::54::62::72::106::119::1
02::::54:2:::54:2:::110::102::::54:2:::54:2:::82::118::102::116::117:::54::58:::::54:3::55::::54:0::
:54::58:::96::55::62::::54:3::58::::54::58:::::54:3::55::::54:0:::54::58:::96::56::62::::54:3::58:::
:54::58:::::54:3::55::::54:0:::54::58:::96::57::62:::54::58:::::54:3::55::::54:0:::54::58:::::54:3::
55:::::54:3::55:::102::111::101::::54:3::55:::::54:3::55::::54::58:::::54:3::55::::54:0:::54::58:::9
6::::54:3::58:::62::56:::54::58:::::54:3::55::::54:0:::54::58:::96:::54:0::62::66::100::117::106::11
2::111::79::112::101::102:::54::58:::::54:3::55::::54:0:::54::58:::96:::54:1::62:::54:3:::54:3::58::
:54:3::::54:3::54::::54:1:::54:0::55::::54:3::58::::54::58:::::54:3::55::::54:0:::54::58:::96:::54:2
::62::57:::54::58:::::54:3::55::::54:0:::54::58:::96:::54:3::62:::54::58:::::54:3::55::::54:0:::54::
58:::96::54::62::72::106::119::102::::54:2:::54:2:::82::118::102::116::117:::54::58:::::54:3::55::::
54:0:::54::58:::96::55::62:::54:0::::54:3::58::::54::58:::::54:3::55::::54:0:::54::58:::96::56::62::
:54:0:::54::58:::::54:3::55::::54:0:::54::58:::96::57::62::85::102::116::117:::54:0:::54:0:::54::58:
::::54:3::55::::54:0:::54::58:::::54:3::55:::::54:3::55:::102::111::101::::54:3::55:::::54:3::55::::
54::58:::::54:3::55::::54:0:::54::58:::96::::54:3::58:::62::57:::54::58:::::54:3::55::::54:0:::54::5
8:::96:::54:0::62::80::113::117::106::112::111::79::112::101::102:::54::58:::::54:3::55::::54:0:::54
::58:::96:::54:1::62:::54:3::57:::54:3::::54:3::58:::::54:3::54::::54:0::58:::54:3:::54:1:::54::58::
:::54:3::55::::54:0:::54::58:::96:::54:2::62::58:::54::58:::::54:3::55::::54:0:::54::58:::96:::54:3:
:62:::54::58:::::54:3::55::::54:0:::54::58:::96::54::62::85::105::98::111::108::116::::54:2:::54:2::
:67::122::102:::54::58:::::54:3::55::::54:0:::54::58:::96::55::62::::54:3::58::::54::58:::::54:3::55
::::54:0:::54::58:::96::56::62::::54:3::58::::54::58:::::54:3::55::::54:0:::54::58:::96::57::62:::54
::58:::::54:3::55::::54:0:::54::58:::::54:3::55:::::54:3::55:::102::111::101::::54:3::55:::::54:3::5
5::::54::58:::::54:3::55::::54:0:::54::58:::96::::54:3::58:::62::58:::54::58:::::54:3::55::::54:0:::
54::58:::96:::54:0::62::66::100::117::106::112::111::79::112::101::102:::54::58:::::54:3::55::::54:0
:::54::58:::96:::54:1::62::54:::54:0:::54:1::55::::54:3::54::::54:0::58:::54:3:::54:0:::54::58:::::5
4:3::55::::54:0:::54::58:::96:::54:2::62:::54::58:::::54:3::55::::54:0:::54::58:::96:::54:3::62:::54
::58:::::54:3::55::::54:0:::54::58:::96::54::62::68::109::112::116::102::::54:2:::54:2:::69::106::98
::109::112::104::118::102:::54::58:::::54:3::55::::54:0:::54::58:::96::55::62::::54:3::58::::54::58:
::::54:3::55::::54:0:::54::58:::96::56::62::::54:3::58::::54::58:::::54:3::55::::54:0:::54::58:::96:
:57::62:::54::58:::::54:3::55::::54:0:::54::58:::::54:3::55:::::54:3::55:::102::111::101::::54:3::55
:::::54:3::55::::54::58:::::54:3::55::::54:0:::54::58:::96::::54:3::58:::62:::54:0::::54:3::58::::54
::58:::::54:3::55::::54:0:::54::58:::96:::54:0::62::80::113::117::106::112::111::79::112::101::102::
:54::58:::::54:3::55::::54:0:::54::58:::96:::54:1::62:::54:3:::54:0::58::55::::54:3::54::::54:1::::5
4:3::58::::54:0:::54:0:::54::58:::::54:3::55::::54:0:::54::58:::96:::54:2::62:::54:0:::54:0:::54::58
:::::54:3::55::::54:0:::54::58:::96:::54:3::62:::54::58:::::54:3::55::::54:0:::54::58:::96::54::62::
68::112::110::113::109::102::117::102::::54:2:::54:2:::82::118::102::116::117:::54::58:::::54:3::55:
:::54:0:::54::58:::96::55::62::::54:3::58::::54::58:::::54:3::55::::54:0:::54::58:::96::56::62::::54
:3::58::::54::58:::::54:3::55::::54:0:::54::58:::96::57::62:::54::58:::::54:3::55::::54:0:::54::58::
:::54:3::55:::::54:3::55:::102::111::101::::54:3::55:::::54:3::55::::54::58:::::54:3::55::::54:0:::5
4::58:::96::::54:3::58:::62:::54:0:::54:0:::54::58:::::54:3::55::::54:0:::54::58:::96:::54:0::62::66
::100::117::106::112::111::79::112::101::102:::54::58:::::54:3::55::::54:0:::54::58:::96:::54:1::62:
::54:3:::54:3::58:::54:1::::54:3::54::::54:1::::54:3::58::::54:0:::54:0:::54::58:::::54:3::55::::54:
0:::54::58:::96:::54:2::62::57:::54::58:::::54:3::55::::54:0:::54::58:::96:::54:3::62:::54::58:::::5
4:3::55::::54:0:::54::58:::96::54::62::68::112::110::113::109::102::117::102::::54:2:::54:2:::82::11
8::102::116::117:::54::58:::::54:3::55::::54:0:::54::58:::96::55::62::::54:3::58::::54::58:::::54:3:
:55::::54:0:::54::58:::96::56::62:::54:0:::54::58:::::54:3::55::::54:0:::54::58:::96::57::62::85::10
2::116::117:::54:0:::54:0:::54::58:::::54:3::55::::54:0:::54::58:::::54:3::55:::::54:3::55:::102::11
1::101::::54:3::55:::::54:3::55::::54::58:::::54:3::55::::54:0:::54::58:::96::::54:3::58:::62:::54:0
:::54:1:::54::58:::::54:3::55::::54:0:::54::58:::96:::54:0::62::69::106::98::109::112::104::118::102
::79::112::101::102:::54::58:::::54:3::55::::54:0:::54::58:::96:::54:1::62:::54:2::58::57:::54:1::::
54:3::54::::54:1:::54:3::58:::54:1:::54::58:::::54:3::55::::54:0:::54::58:::96:::54:2::62:::54:1:::5
4:2:::54::58:::::54:3::55::::54:0:::54::58:::96:::54:3::62:::54::58:::::54:3::55::::54:0:::54::58:::
96::54::62::90::112::118::::54:3::::54:3::58::::119::102::::54:2:::54:2:::68::109::106::100::108::10
2::101::::54:2:::54:2:::85::106::100::::54:2:::54:2:::::54:2:::54:2:::61::109::112::100::119::98::11
5::62::85::106::100::63::::54:2:::54:2:::117::106::110::102::116::::54:3::56:::61::99::115::63:::54:
:58:::::54:3::55::::54:0:::54::58:::96::55::62:::54:0:::54::58:::::54:3::55::::54:0:::54::58:::96::5
6::62::55::::54:3::58::::54::58:::::54:3::55::::54:0:::54::58:::96::57::62:::54::58:::::54:3::55::::
54:0:::54::58:::::54:3::55:::::54:3::55:::102::111::101::::54:3::55:::::54:3::55::::54::58:::::54:3:
:55::::54:0:::54::58:::96::::54:3::58:::62:::54:0:::54:2:::54::58:::::54:3::55::::54:0:::54::58:::96
:::54:0::62::80::113::117::106::112::111::79::112::101::102:::54::58:::::54:3::55::::54:0:::54::58::
:96:::54:1::62:::54:2::::54:3::58:::58::57::::54:3::54::::54:1:::54:3::57::54:::54::58:::::54:3::55:
:::54:0:::54::58:::96:::54:2::62:::54:1::::54:3::58::::54::58:::::54:3::55::::54:0:::54::58:::96:::5
4:3::62:::54::58:::::54:3::55::::54:0:::54::58:::96::54::62::85::106::100:::54::58:::::54:3::55::::5
4:0:::54::58:::96::55::62::::54:3::58::::54::58:::::54:3::55::::54:0:::54::58:::96::56::62::::54:3::
58::::54::58:::::54:3::55::::54:0:::54::58:::96::57::62:::54::58:::::54:3::55::::54:0:::54::58:::::5
4:3::55:::::54:3::55:::102::111::101::::54:3::55:::::54:3::55::::54::58:::::54:3::55::::54:0:::54::5
8:::96::::54:3::58:::62:::54:0:::54:3:::54::58:::::54:3::55::::54:0:::54::58:::96:::54:0::62::80::11
3::117::106::112::111::79::112::101::102:::54::58:::::54:3::55::::54:0:::54::58:::96:::54:1::62:::54
:2::::54:3::58:::58::58::::54:3::54::::54:1::55:::54:3::58:::54::58:::::54:3::55::::54:0:::54::58:::
96:::54:2::62:::54:1:::54:0:::54::58:::::54:3::55::::54:0:::54::58:::96:::54:3::62:::54::58:::::54:3
::55::::54:0:::54::58:::96::54::62::85::112::100:::54::58:::::54:3::55::::54:0:::54::58:::96::55::62
::::54:3::58::::54::58:::::54:3::55::::54:0:::54::58:::96::56::62::::54:3::58::::54::58:::::54:3::55
::::54:0:::54::58:::96::57::62:::54::58:::::54:3::55::::54:0:::54::58:::::54:3::55:::::54:3::55:::10
2::111::101::::54:3::55:::::54:3::55::::54::58:::::54:3::55::::54:0:::54::58:::96::::54:3::58:::62::
:54:0::54:::54::58:::::54:3::55::::54:0:::54::58:::96:::54:0::62::69::106::98::109::112::104::118::1
02::79::112::101::102:::54::58:::::54:3::55::::54:0:::54::58:::96:::54:1::62:::54:2::58::57:::54:1::
::54:3::54::::54:1::55:::54:3::54:::54::58:::::54:3::55::::54:0:::54::58:::96:::54:2::62:::54:1:::54
:2:::54::58:::::54:3::55::::54:0:::54::58:::96:::54:3::62:::54::58:::::54:3::55::::54:0:::54::58:::9
6::54::62::90::112::118::::54:3::::54:3::58::::119::102::::54:2:::54:2:::68::109::106::100::108::102
::101::::54:2:::54:2:::85::112::100::::54:2:::54:2:::61::109::112::100::119::98::115::62::85::112::1
00::63::::54:2:::54:2:::117::106::110::102::116::::54:3::56:::61::99::115::63:::54::58:::::54:3::55:
:::54:0:::54::58:::96::55::62:::54:0:::54::58:::::54:3::55::::54:0:::54::58:::96::56::62::55::::54:3
::58::::54::58:::::54:3::55::::54:0:::54::58:::96::57::62:::54::58:::::54:3::55::::54:0:::54::58::::
:54:3::55:::::54:3::55:::102::111::101::::54:3::55:::::54:3::55::::54::58:::::54:3::55::::54:0:::54:
:58:::96::::54:3::58:::62:::54:0::55:::54::58:::::54:3::55::::54:0:::54::58:::96:::54:0::62::80::113
::117::106::112::111::79::112::101::102:::54::58:::::54:3::55::::54:0:::54::58:::96:::54:1::62:::54:
2::::54:3::58:::58::58::::54:3::54::::54:1::57:::54:0::::54:3::58::::54::58:::::54:3::55::::54:0:::5
4::58:::96:::54:2::62:::54:0::56:::54::58:::::54:3::55::::54:0:::54::58:::96:::54:3::62:::54::58::::
:54:3::55::::54:0:::54::58:::96::54::62::83::102::116::102::117:::54::58:::::54:3::55::::54:0:::54::
58:::96::55::62::::54:3::58::::54::58:::::54:3::55::::54:0:::54::58:::96::56::62::::54:3::58::::54::
58:::::54:3::55::::54:0:::54::58:::96::57::62:::54::58:::::54:3::55::::54:0:::54::58:::::54:3::55:::
::54:3::55:::102::111::101::::54:3::55:::::54:3::55::::54::58:::::54:3::55::::54:0:::54::58:::96::::
54:3::58:::62:::54:0::56:::54::58:::::54:3::55::::54:0:::54::58:::96:::54:0::62::66::100::117::106::
112::111::79::112::101::102:::54::58:::::54:3::55::::54:0:::54::58:::96:::54:1::62:::54:2:::54:2::58
::::54:3::58:::::54:3::54::::54:1::57:::54:0:::54:3:::54::58:::::54:3::55::::54:0:::54::58:::96:::54
:2::62:::54:0::57:::54::58:::::54:3::55::::54:0:::54::58:::96:::54:3::62:::54::58:::::54:3::55::::54
:0:::54::58:::96::54::62::77::112::100::87::98::115::::54:2:::54:2:::80::113::102::115::98::117::106
::112::111:::54::58:::::54:3::55::::54:0:::54::58:::96::55::62:::54:1:::54::58:::::54:3::55::::54:0:
::54::58:::96::56::62::::54:3::58::::54::58:::::54:3::55::::54:0:::54::58:::96::57::62::85::106::100
:::54::58:::::54:3::55::::54:0:::54::58:::::54:3::55:::::54:3::55:::102::111::101::::54:3::55:::::54
:3::55::::54::58:::::54:3::55::::54:0:::54::58:::96::::54:3::58:::62:::54:0::57:::54::58:::::54:3::5
5::::54:0:::54::58:::96:::54:0::62::66::100::117::106::112::111::79::112::101::102:::54::58:::::54:3
::55::::54:0:::54::58:::96:::54:1::62:::54:2::55::57::54::::54:3::54::::54:1::57:::54:0::55:::54::58
:::::54:3::55::::54:0:::54::58:::96:::54:2::62:::54:0::58:::54::58:::::54:3::55::::54:0:::54::58:::9
6:::54:3::62:::54::58:::::54:3::55::::54:0:::54::58:::96::54::62::77::112::100::87::98::115::::54:2:
::54:2:::80::113::102::115::98::117::106::112::111:::54::58:::::54:3::55::::54:0:::54::58:::96::55::
62:::54:1:::54::58:::::54:3::55::::54:0:::54::58:::96::56::62::::54:3::58::::54::58:::::54:3::55::::
54:0:::54::58:::96::57::62::85::112::100:::54::58:::::54:3::55::::54:0:::54::58:::::54:3::55:::::54:
3::55:::102::111::101::::54:3::55:::::54:3::55::::54::58:::::54:3::55::::54:0:::54::58:::96::::54:3:
:58:::62:::54:0::58:::54::58:::::54:3::55::::54:0:::54::58:::96:::54:0::62::69::106::98::109::112::1
04::118::102::79::112::101::102:::54::58:::::54:3::55::::54:0:::54::58:::96:::54:1::62:::54:2::58::5
7:::54:2::::54:3::54::::54:1::57:::54:0:::54:2:::54::58:::::54:3::55::::54:0:::54::58:::96:::54:2::6
2:::54:1:::54:2:::54::58:::::54:3::55::::54:0:::54::58:::96:::54:3::62:::54::58:::::54:3::55::::54:0
:::54::58:::96::54::62::85::106::100::::54:2:::54:2:::85::112::100::::54:2:::54:2:::68::109::102::98
::115::102::101::61::99::115::63:::54::58:::::54:3::55::::54:0:::54::58:::96::55::62:::54:0:::54::58
:::::54:3::55::::54:0:::54::58:::96::56::62::55::::54:3::58::::54::58:::::54:3::55::::54:0:::54::58:
::96::57::62:::54::58:::::54:3::55::::54:0:::54::58:::::54:3::55:::::54:3::55:::102::111::101::::54:
3::55:::::54:3::55::::54::58:::::54:3::55::::54:0:::54::58:::96::::54:3::58:::62:::54:1::::54:3::58:
:::54::58:::::54:3::55::::54:0:::54::58:::96:::54:0::62::66::100::117::106::112::111::79::112::101::
102:::54::58:::::54:3::55::::54:0:::54::58:::96:::54:1::62:::54:2::55::57:::54:0::::54:3::54::::54:1
:::54:3::58:::54:1:::54::58:::::54:3::55::::54:0:::54::58:::96:::54:2::62:::54:0:::54:1:::54::58::::
:54:3::55::::54:0:::54::58:::96:::54:3::62:::54::58:::::54:3::55::::54:0:::54::58:::96::54::62::77::
112::100::87::98::115::::54:2:::54:2:::80::113::102::115::98::117::106::112::111:::54::58:::::54:3::
55::::54:0:::54::58:::96::55::62::::54:3::58::::54::58:::::54:3::55::::54:0:::54::58:::96::56::62:::
:54:3::58::::54::58:::::54:3::55::::54:0:::54::58:::96::57::62::85::106::100:::54::58:::::54:3::55::
::54:0:::54::58:::::54:3::55:::::54:3::55:::102::111::101::::54:3::55:::::54:3::55::::54::58:::::54:
3::55::::54:0:::54::58:::96::::54:3::58:::62:::54:1:::54:0:::54::58:::::54:3::55::::54:0:::54::58:::
96:::54:0::62::66::100::117::106::112::111::79::112::101::102:::54::58:::::54:3::55::::54:0:::54::58
:::96:::54:1::62:::54:2::55::57:::54:1::::54:3::54::::54:1::55::54:::54:2:::54::58:::::54:3::55::::5
4:0:::54::58:::96:::54:2::62:::54:0::54:::54::58:::::54:3::55::::54:0:::54::58:::96:::54:3::62:::54:
:58:::::54:3::55::::54:0:::54::58:::96::54::62::77::112::100::87::98::115::::54:2:::54:2:::80::113::
102::115::98::117::106::112::111:::54::58:::::54:3::55::::54:0:::54::58:::96::55::62::::54:3::58::::
54::58:::::54:3::55::::54:0:::54::58:::96::56::62::::54:3::58::::54::58:::::54:3::55::::54:0:::54::5
8:::96::57::62::85::112::100:::54::58:::::54:3::55::::54:0:::54::58:::::54:3::55:::::54:3::55:::102:
:111::101::::54:3::55:::::54:3::55::::54::58:::::54:3::55::::54:0:::54::58:::96::::54:3::58:::62:::5
4:1:::54:1:::54::58:::::54:3::55::::54:0:::54::58:::96:::54:0::62::67::112::118::111::100::102::79::
112::101::102:::54::58:::::54:3::55::::54:0:::54::58:::96:::54:1::62:::54:1::56::::54:3::58:::55::::
54:3::54::::54:1::54:::54:2::58:::54::58:::::54:3::55::::54:0:::54::58:::96:::54:2::62:::54:0:::54:2
::::54:3::54::::54:0:::54:3::::54:3::54::::54:0::55:::54::58:::::54:3::55::::54:0:::54::58:::96:::54
:3::62:::54::58:::::54:3::55::::54:0:::54::58:::96::54::62::77::98::111::101:::54::58:::::54:3::55::
::54:0:::54::58:::96::55::62::::54:3::58::::54::58:::::54:3::55::::54:0:::54::58:::96::56::62::::54:
3::58::::54::58:::::54:3::55::::54:0:::54::58:::96::57::62:::54::58:::::54:3::55::::54:0:::54::58:::
::54:3::55:::::54:3::55:::102::111::101::::54:3::55:::::54:3::55::::54::58:::::54:3::55::::54:0:::54
::58:::96::::54:3::58:::62:::54:1:::54:2:::54::58:::::54:3::55::::54:0:::54::58:::96:::54:0::62::67:
:112::118::111::100::102::79::112::101::102:::54::58:::::54:3::55::::54:0:::54::58:::96:::54:1::62::
:54:3:::54:2::58::56::::54:3::54::::54:1::56::::54:3::58:::55:::54::58:::::54:3::55::::54:0:::54::58
:::96:::54:2::62:::54::58:::::54:3::55::::54:0:::54::58:::96:::54:3::62:::54::58:::::54:3::55::::54:
0:::54::58:::96::54::62::67::112::118::111::100::102:::54::58:::::54:3::55::::54:0:::54::58:::96::55
::62:::54:1:::54:1:::54::58:::::54:3::55::::54:0:::54::58:::96::56::62::::54:3::58::::54::58:::::54:
3::55::::54:0:::54::58:::96::57::62:
